NO ./textures/NO.xpm
SO ./textures/SO.xpm
WE ./textures/WE.xpm
EA ./textures/EA.xpm

F 20,100,0
C 225,30,0

   111
  11011
 1100011
1100N0011
111111111